NO ./imgs/n_basement.xpm
SO ./imgs/s_basement.xpm
WE ./imgs/w_basement.xpm
EA ./imgs/e_basement.xpm
F 80,80,80
C 0,50,0

11111111111111111111111111111111111111111111111111111111111111111111111111
10000000000000000000000000000000001000000000000000000000000000000000000D01
1D1111111111111111111111111111111D1D111111111111111111D1111111111111111101
1000000000000000000000000000000000001                101               101
1000000000000000000000000000000000001                101               101
1111111111111111111111111111111111D11                101               101
100000000000000000000000000000000000111111111111111111D1111            101
10000000000000000000000000000000000000000000000000000000001111111      101
100000000000000000000000000N000000000000000000000000000000D000001      101
11111D11111111111000000000000000000000000000000000000000001111101      101
    101         1000000000000000000000000000000000000000001   101      101
    101         1111111111111111111111111111111111111111111   101      101
    101                                                       101      101
    101                                                       101      101
    101                                                       101      101
11111D111111111111111111111111111111111111111111111111111111111D1      101
10000000000000000000000000000000010000000000000000000000000000001      101
10000000000000000000000000000000010000000000000000000000000000001      101
100000000000000000000000000000000D0000000000000000000000000000001      101
10000000000000000000000000000000010000000000000000000000000000001111111101
1000000000000000000000000000000001000000000000000000000000000000D000000D01
1111111111111D111111111111111111110000000000000000000000000000001111111101
            101                  10000000000000000000000000000001      101
  111111111110111111111111111111110000000000000000000000000000001      101
  1000000000000000000000000000000D0000000000000000000000000000001      101
  1D1111111111111111111111111111111111111111111111111111111111111      101
  100000000001                                                         101
  100000000001111111111111111111111111111111111111111111111111111111111101
  10000000000D000000000000000000000000000000000000000000000000000000000001
  100000000001111111111111111111111111111111111111111111111111111111111111
  111111111111
