NO ./imgs/n_mil.xpm
SO ./imgs/s_nap.xpm
WE ./imgs/w_fio.xpm
EA ./imgs/e_juv.xpm
F 100,100,100
C 200,200,200

1111
10011
11001111111111111111
110000000000111111111
1000000000000000000011111111111111
1100000000000000000000001111111111
110000011111111111111000000000001
11000111          111111110000011
110001        1          10000001111111
110111                   111110111
11001111111111111111111111000000011
11D1111100000000000000000111110111
1100000000000S000000D0000000000I
10000000000000000000000000000001111
11111111111111111111111111111111
1111111111
1       1
111111111
1111
