NO ./imgs/n_mil.xpm
SO ./imgs/s_nap.xpm
WE ./imgs/w_fio.xpm
EA ./imgs/e_juv.xpm
F 220,100,0
C 225,30,0

111
10011
11001111111111111111
11000000000011111111
1000000000000000000011111111111111
1100000000000000000000001111111111
110000011111111111111000000000001
1100011           111111110000011
110001        1          10000001111111
11011                    11111011
11001111111111111111111111000000011
1101111100000000000000000111110111
1100000000000N00000000000000000w
10000000000000000000000000000001111
11111111111111111111111111111111
1111111111
1       1
111111111
1111