NO ./imgs/n_stone.xpm
SO ./imgs/s_stone.xpm
WE ./imgs/w_stone.xpm
EA ./imgs/e_stone.xpm
F  0, 100, 0
C  173, 216, 230


111111111111111111111111111111111111111111111111
100000001000000000000000000000000000000000000001
101111101111111000011111111111110111111111110101
100000000000001000010000000000000100000000000001
100000000000001000010000000000000000000000000001
101111100000001111110111111111110100000000000001
100000100000000000000000000000000100000000000001
100000100000000011111111111111111100000000000001
100000100000000010000000000000000000000000000001
100000100000000010000000000000000000000000000001
100000100000000010011111111111111100000000000001
100000111111111111000000000000000100000000000001
100000000000000000000000000000000111111101111111
100000000000000000000000000000000100000000000001
101111111111111111111111111111111100000000000001
100000000000000000010000000000000000000000000001
100000000000000000010000000000000000000000000001
100000000000000000010000000000000000000000000001
100000000000000000010000000000000000000000000001
101111111111111111111111111110111111111000000001
100000000000000000000000000000000000001000000001
100000000000001000000000000000000000001000000001
100000000000001000000000000000000000001000000001
100000000000001000000000000000000000001000000001
10000000000000100000000000000N000000001000000001
100000000000001000000000000000000000001000000001
100000000000001000000000000000000000001000000001
100000000000001000000000000000000000001000000001
111111111111111111111111111111111111111111111111

