NO ./imgs/pcn.xpm
SO ./imgs/pcs.xpm
EA ./imgs/pce.xpm
WE ./imgs/pcw.xpm

F 150,150,150
C 230,230,230

                                           1111111111111111
                                      111111000000S0000000111111
                                  1111100000000000000000000000011111
                                 110000000000000000000000000000000011
                                11100000000000000000000000000000000111
                                10110000000000000000000000000000001101
                               1101111100000000000000000000000011111011
                      1111111111000000111111000000000000001111110000001111111111
                  111110000000010000000000011D1111111111D110000000000010000000011111
            111111100000000000010000000000000000000000000000000000000010000000000001111111
        11111000000000000000000100000000000000000000000000000000000000100000000000000000011111
     11110000000000000000000000100000000000000000000000000000000000000100000000000000000000001111
   1110000000000000000000000000D00000000000000000000000000000000000000D0000000000000000000000000111
  11000000000000000000000000000100000000000000000000000000000000000000100000000000000000000000000011
 1100000000000000000000000000001110000000000000000000000000000000000111000000000000000000000000000011
110000000000000000000000000000000111111000000000000000000000000111111000000000000000000000000000000011
 1100000000000000000000000000000000000111111111111111111111111110000000000000000000000000000000000011
  11000000000000000000000000000000000000000000000000000000000000000000000000000000000000000000000011
   111000000000000000000000000000000000000000000000000000000000000000000000000000000000000000000111
     11110000000000000000000000000000000000000000000000000000000000000000000000000000000000001111
        11111000000000000000000000000000000000000000000000000000000000000000000000000000011111
            111111100000000000000000000000000000000000000000000000000000000000000001111111
                  111110000000000000000000000000000000000000000000000000000000011111
                      1111111111000000000000000000000000000000000000001111111111
                               1111111111111111111111111111111111111111
