NO ./imgs/n_stone.xpm
SO ./imgs/s_stone.xpm
WE ./imgs/w_stone.xpm
EA ./imgs/e_stone.xpm
F  0, 100, 0
C  173, 216, 230


111111111111111111
100000000000000001
111111111110000001
100000000010000001
101111111110000001
100000001111100111
100010000000000001
100010001110000001
100010000010000N01
100010000010000001
111111111111111111

